SO ./assets/textures/walls/eagle.xpm
WE ./assets/textures/walls/greystone.xpm
NO ./assets/textures/walls/dungeon_wall1.xpm
EA ./assets/textures/walls/supersuper.xpm
D ./assets/textures/walls/door.xpm

P ./assets/textures/walls/animation.xpm:1000
B ./assets/textures/sprites/barril.xpm:200

F 0,0,0
C 0,0,127

        1111111111111111111111111
        1000000000110000000000001
        1011000001110000000000001
        100100000DDD0000000000001
111111111011000001110000000000001
10000000001100000111011111R111111
11110111111111011100000010001
1111D111111111011101010010001
1100000011010101110000001B001
1B00000000000s00110000001P0b1
100s0000000000001101010010001
11000001110101011111011110W0111
11110111 1110101 101111010001
11111111 1111111 111111111111
