NO ./assets/textures/simple_wall.xpm
SO ./assets/textures/simple_wall.xpm
WE ./assets/textures/simple_wall.xpm
EA ./assets/textures/simple_wall.xpm

F 220,100,0
C 225,30,0

1111111111111111
1000000000000001
10000000000000011111111111111111111
10000000000000000000000000000000000N
11111111111111111111111111111111111
1111111111111111
