NO ./assets/textures/simple_wall.xpm
SO ./assets/textures/simple_wall.xpm
WE ./assets/textures/simple_wall.xpm
EA ./assets/textures/simple_wall.xpm

F 255,0,255
C 0,255,0

11111
10001
10W01
10001
11111
