SO ./assets/textures/walls/eagle.xpm
WE ./assets/textures/walls/greystone.xpm
NO ./assets/textures/walls/dungeon_wall1.xpm
EA ./assets/textures/walls/supersuper.xpm
D ./assets/textures/walls/door.xpm

P ./assets/textures/walls/animation.xpm:100
B ./assets/textures/sprites/barril.xpm:200

F 0,0,0
C 0,0,127

        1111111111111111111111111
        100000000011PPPPPPPPPPPP1
        101100000111PPPPPPPPPPPP1
        100100000DDDPPPPPPPPPPPP1
111111111011000001110000000000001
10000000001100000111011111D111111
11110111111111011100000010001
1111D111111111011101010010001
1100000011010101110000001B001
1B00000000000s00110000001P0b1
100s0000000000001101010010001
11000001110101011111011110W0111
11110111 1110101 101111010001
11111111 1111111 111111111111
