NO assets/textures/dungeon_wall1.xpm
SO assets/textures/dungeon_wall1.xpm
WE assets/textures/dungeon_wall1.xpm
EA assets/textures/dungeon_wall1.xpm
C 0,0,60
F 60,179,110


        11111111111111111111111111
        10000000001100000000000001
        10110000011 110000010000001
        1001000000010000001 100011
111111111011000001110000000100001
100000000011000001110111110111111
11110111111111011100000010001
11110111111111011101010010001
11000000110101011100000010001
10000000000000001100W00100011
10000000000000001101010010001
11000001110101011111011110001
11110111 10110101 11111010001
11111111 1111111 111111111111