SO ./textures/eagle.xpm
WE ./textures/animation.xpm
NO ./textures/barril.xpm
EA ./textures/bookshelf.xpm

F 0,0,0
C 255,255,255

        1111111111111111111111111
        1000000000110000000000001
        1011000001110000000000001
        1001000000000000000000001
11111111101100000111000000000P001
100000000011000001110111110111111
11110111111111011100000010001
11110111111111011101010010001
1100000011010101110000001P001
1000000000000000110000001P001
10000000000000001101010010001
11000001110101011111011110N0111
11110111 1110101 101111010001
11111111 1111111 111111111111
