NO ./textures/simple_wall.xpm
SO ./textures/simple_wall.xpm
WE ./textures/simple_wall.xpm
EA ./textures/simple_wall.xpm

F 220,100,0
C 225,30,0

1111111111111111
1000000000000001
1000000000N000011111111111111111111
100000000000000000000000000000000000000000000000000000000
11111111111111111111111111111111111
1111111111111111
