NO ./textures/simple_wall.xpm
SO ./textures/simple_wall.xpm
WE ./textures/simple_wall.xpm
EA ./textures/simple_wall.xpm
F 255,0,255
C 0,255,0

1111111
1000001
100N001
1000001
1111111







11111111111111111111111111
10000000000000000000000001
11111111000000000000000001
       1000000000000000001
11111111111111111000000001
10000000000000000000000001
11111111111111111111111111